1 1 1 1 1 1 1 1 1 1 1 1 1 1 1 1
1 0 0 0 1 0 0 0 5 0 0 0 2 0 0 1
1 0 1 0 2 1 2 1 2 1 0 1 0 1 2 1
1 5 0 0 0 0 0 2 0 0 0 0 2 5 0 1
1 0 1 0 2 1 0 1 2 1 0 1 0 1 0 1
1 0 0 0 0 0 0 0 0 0 0 0 6 0 1 1
1 0 1 0 2 1 6 0 0 1 0 1 0 1 0 1
1 0 0 0 0 0 0 0 0 0 0 0 6 0 0 1
1 0 1 0 2 1 0 0 0 1 0 1 0 1 0 1
1 0 0 0 0 7 0 0 0 0 0 0 6 0 0 1
1 0 2 0 0 2 0 0 0 0 0 0 0 2 0 1
1 1 1 1 1 1 1 1 1 1 1 1 1 1 1 1



